1111111111111111111111111
1E00000!0000C00000C000001
1010100100000101001011001
1010010101010001001000001
1P0000C00C000000000000!C1
1111111111111111111111111